........
........
........
........
...6....
...4....
...325..
....1...